level 3.5
next_level assets/maps/level_1_5.map
next_level assets/maps/level_5_5.map
next_level assets/maps/level_4_5.map
next_level assets/maps/level_2_5.map
map
# # # # D # # # # # # # # # # # # # # -1
# 0 0 0 0 0 0 E 0 0 0 0 0 # 0 0 0 0 # -1
D 0 0 # 0 # 0 0 0 0 # 0 0 0 0 0 0 0 # -1
# # # # # # # 0 0 # # # 0 E 0 0 S 0 # -1
D 0 0 # 0 # 0 0 0 0 # 0 0 0 0 0 0 0 # -1
# 0 0 0 0 0 0 E 0 0 0 0 0 # 0 0 0 0 # -1
# # # # D # # # # # # # # # # # # # # -2