level 1.4
next_level assets/maps/level_2_4.map
map
# # # # # # # # # # # -1
# 0 0 0 # 0 0 0 0 0 # -1
# # # 0 0 0 0 E 0 0 D -1
# S 0 0 # 0 0 0 0 0 # -1
# # # # # # # # # # # -2