level 1.1
next_level assets/maps/level_2_1.map
map
# # # # # # # # # -1
# 0 0 0 0 0 0 0 # -1
# S 0 0 E 0 0 0 D -1
# 0 0 0 0 0 0 0 # -1
# # # # # # # # # -2