level 4.3
next_level assets/maps/level_3_3.map
next_level assets/maps/level_5_3.map
next_level assets/maps/level_1_3.map
next_level assets/maps/level_2_3.map
map
# # # # D # # # # # D # -1
# 0 0 0 0 0 0 0 0 0 0 # -1
D 0 0 0 # 0 0 0 # 0 0 # -1
# 0 0 0 # 0 0 0 # 0 0 # -1
# E # # # 0 # 0 # # 0 # -1
# 0 0 0 0 0 # 0 0 0 0 D -1
# 0 # 0 # # # 0 # # 0 # -1
# 0 # 0 0 0 0 0 # 0 0 # -1
# 0 0 0 0 S 0 0 E 0 0 # -1
# # # # # # # # # # # # -2