level 1.3
next_level assets/level_2_3.map
map
# # # # # D # -1
# 0 0 0 # 0 # -1
# 0 # 0 # 0 # -1
# 0 # 0 # 0 # -1
# 0 # 0 # 0 # -1
# S # 0 0 0 # -1
# # # # # # # -2