level 1.5
next_level assets/maps/level_2_5.map
map
# # # # # # # # # -1
# 0 0 0 0 0 0 0 # -1
# 0 0 0 # 0 0 0 # -1
# 0 S 0 # 0 E 0 D -1
# 0 0 0 # 0 0 0 # -1
# 0 0 0 0 0 0 0 # -1
# # # # # # # # # -2