level 1.2
next_level assets/level_2_2.map
next_level assets/level_3.map
map
# # L # # -1
# 0 0 0 # -1
D 0 K 0 D -1
# 0 0 0 # -1
# 0 0 0 # -1
# 0 0 0 # -1
# 0 S 0 # -1
# 0 0 0 # -1
# # # # # -2