level 2.3
next_level assets/maps/level_1_3.map
next_level assets/maps/level_3.map
map
# # L # # # # # # # # -1
# 0 0 0 0 0 # 0 0 K # -1
# 0 E 0 0 0 # 0 # # # -1
# 0 0 0 0 0 0 0 0 0 # -1
# 0 0 0 # # # 0 # # # -1
# 0 0 0 # 0 0 0 0 0 # -1
# 0 0 0 # 0 0 0 0 0 # -1
# 0 S 0 # 0 0 0 0 0 # -1
# 0 0 0 # 0 0 0 0 0 # -1
# # D # # # # L # # # -2