level 6
next_level assets/maps/level_1_1.map
next_level assets/maps/level_1_2.map
next_level assets/maps/level_1_3.map
next_level assets/maps/level_1_4.map
next_level assets/maps/level_1_5.map
map
# # # # # # # # D # # # # # # # # -1
# 0 0 0 0 0 0 0 0 0 0 0 0 # 0 0 # -1
D 0 0 # 0 0 # # 0 # # 0 0 # 0 0 # -1
# 0 0 # 0 0 # 0 0 0 # 0 0 # 0 0 # -1
# 0 0 # 0 0 0 0 S 0 0 0 0 0 0 0 D -1
# 0 0 # 0 0 # 0 0 0 # 0 0 # 0 0 # -1
D 0 0 # 0 0 # # 0 # # 0 0 # 0 0 # -1
# 0 0 0 0 0 0 0 0 0 0 0 0 # 0 0 # -1
# # # # # # # # D # # # # # # # # -2