level 5.2
next_level assets/maps/level_1_2.map
next_level assets/maps/level_6.map
next_level assets/maps/level_4_2.map
next_level assets/maps/level_2_2.map
map
# # # # # # # # L # # # # # # # # -1
# 0 0 0 E 0 0 0 S 0 0 0 E 0 0 0 # -1
# 0 0 0 0 # 0 0 0 0 0 # 0 0 0 0 # -1
# 0 0 # # # 0 0 # 0 0 # # # 0 0 # -1
# 0 # # 0 0 0 0 # 0 0 0 0 # # 0 # -1
L 0 0 0 0 0 # # # # # 0 0 0 0 0 L -1
# 0 # # 0 0 0 0 # 0 0 0 0 # # 0 # -1
# 0 0 # # # 0 0 # 0 0 # # # 0 0 # -1
# 0 K 0 0 # 0 0 0 0 0 # 0 0 0 0 # -1
# 0 0 E 0 0 0 0 0 0 0 0 E 0 0 0 # -1
# # # # # # # # L # # # # # # # # -2