level 1.2
next_level assets/maps/level_2_2.map
map
# # L # # -1
# 0 0 0 # -1
# 0 K 0 # -1
# 0 0 0 # -1
# 0 E 0 # -1
# 0 0 0 # -1
# 0 S 0 # -1
# 0 0 0 # -1
# # # # # -2