level 1
next_level assets/level_2.map
map
# # L # # -1
# 0 K 0 # -1
# 0 0 0 # -1
# 0 S 0 # -1
# # # # # -2